XXXXXXXXXXXXXXXXXXXXXXXXXXXXXXX
X                          X 
X                          X
X                          X
X                    X
X
X
X
X
X
XX
X
X
X
X
X
XX
X
X                            X
X
X                            X
X                            X
X    P  X      E     X        X
XXXXXXXXXXXXXXXXXXXXXXXXXXXXXX
